Event: [After, Before, Type]
ItemProfile: [ItemId, ProfileId]
ItemToWeapon: [ItemId, WeaponId]
CharacterName: [CharacterId, Name]
ItemType: [Code, ItemTypeId, Name]
Profile2: [Description, ProfileId]
Image: [Description, ImageId, Path]
VehicleFaction: [FactionId, VehicleId]
ResistType: [Description, ResistTypeId]
TargetType: [Description, TargetTypeId]
Title: [Name, TitleId]
CharactersWorld: [CharacterId, WorldId]
ArmorFacing: [ArmorFacingId, Description]
PlayerState: [Description, PlayerStateId]
ItemAttachment: [AttachmentItemId, ItemId]
Experience: [Description, ExperienceId, Xp]
FacilityType: [Description, FacilityTypeId]
FireModeType: [Description, FireModeTypeId]
ResourceType: [Description, ResourceTypeId]
RewardGroupToReward: [RewardGroupId, RewardId]
WorldEvent: [After, Before, Id, Type, WorldId]
ProfileArmorMap: [ArmorInfoId, ProfileId, Rank]
CharactersEventGrouped: [CharacterId, Id, Type]
FireModeToProjectile: [FireModeId, ProjectileId]
MetagameEventState: [MetagameEventStateId, Name]
ProfileResistMap: [ProfileId, Rank, ResistInfoId]
World: [DescriptionT4Id, NameT4Id, State, WorldId]
OutfitRank: [Description, Name, Ordinal, OutfitId]
Loadout: [CodeName, FactionId, LoadoutId, ProfileId]
RewardSetToRewardGroup: [RewardGroupId, RewardSetId]
ItemCategory: [ItemCategoryId, Name]
MapHex: [HexType, MapRegionId, TypeName, X, Y, ZoneId]
CharactersEvent: [After, Before, CharacterId, Id, Type]
WeaponToAttachment: [AttachmentId, ItemId, WeaponGroupId]
WeaponToFireGroup: [FireGroupId, FireGroupIndex, WeaponId]
ObjectiveSetToObjective: [ObjectiveGroupId, ObjectiveSetId]
ProjectileFlightType: [Description, ProjectileFlightTypeId]
FacilityLink: [Description, FacilityIdA, FacilityIdB, ZoneId]
FireGroupToFireMode: [FireGroupId, FireModeId, FireModeIndex]
CharactersSkill: [CharacterId, LastSave, SkillId]
VehicleSkillSet: [DisplayIndex, FactionId, SkillSetId, VehicleId]
PlayerStateGroup: [MinConeOfFire, PlayerState, PlayerStateGroupId]
Currency: [CurrencyId, IconId, InventoryCap, Name]
Region: [InitialFactionId, Name, RegionId, ZoneId]
VehicleAttachment: [Description, FactionId, ItemId, SlotId, VehicleId]
DirectiveTreeCategory: [DirectiveTreeCategoryId, Name]
MarketingBundleItem: [ItemId, MarketingBundleId, Quantity, ReleaseTime]
ArmorInfo: [ArmorAmount, ArmorFacingId, ArmorInfoId, ArmorPercent, Description]
ImageSet: [Description, ImagePath, ImageSetId, TypeDescription, TypeId]
Zone: [Code, Description, HexSize, Name, ZoneId]
OutfitMember: [CharacterId, MemberSince, OutfitId, Rank, RankOrdinal]
CharactersCurrency: [CharacterId, CurrencyId, CurrencyName, PrestigeCurrency, Quantity]
ImageSetDefault: [Description, ImagePath, ImageSetId, TypeDescription, TypeId]
Reward: [CountMax, CountMin, RewardId, RewardTypeId]
CharactersWeaponStat: [CharacterId, ItemId, LastSave, StatName, Value, VehicleId]
WeaponAmmoSlot: [Capacity, ClipSize, RefillAmmoDelayMs, RefillAmmoRate, WeaponId, WeaponSlotIndex]
RewardType: [CountMax, CountMin, Description, RewardTypeId]
CharactersDirective: [CharacterId, CompletionTime, DirectiveId, DirectiveTreeId]
Faction: [CodeTag, FactionId, ImagePath, ImageSetId, Name, UserSelectable]
CharactersDirectiveObjective: [CharacterId, DirectiveId, ObjectiveGroupId, ObjectiveId, StateData, Status]
ResistInfo: [Description, MultiplierWhenHeadshot, ResistAmount, ResistInfoId, ResistPercent, ResistTypeId]
CharactersDirectiveTier: [CharacterId, CompletionTime, DirectiveTierId, DirectiveTreeId]
MetagameEvent: [Description, ExperienceBonus, MetagameEventId, Name, Type]
CharactersStatHistory: [AllTime, CharacterId, Day, LastSave, Month, OneLifeMax, StatName, Week]
MarketingBundleWith1Item: [CertPrice, ItemId, ItemQuantity, MarketingBundleId, ReleaseTime, StationCashPrice]
WorldStatHistory: [AllTime, Day, Faction, LastSave, Month, StatName, TrackerName, Type, Week, WorldId]
Outfit: [Alias, AliasLower, LeaderCharacterId, MemberCount, Name, NameLower, OutfitId, TimeCreated]
ObjectiveType: [Description, ObjectiveTypeId]
FireGroup: [CanChamberIronsights, ChamberDurationMs, FireGroupId, SpoolUpInitialRefireMs, SpoolUpMs, TransitionDurationMs]
Character: [BattleRank, Certs, DailyRibbon, CharacterId, FactionId, HeadId, Name, PrestigeLevel, ProfileId, Times, TitleId]
CharactersWeaponStatByFaction: [CharacterId, ItemId, LastSave, StatName, ValueNc, ValueTr, ValueVs, VehicleId]
ExperienceRank: [Imagesettitle<Nc>, NcImagePath, Rank, Imagesettitle<Tr>, TrImagePath, Imagesettitle<Vs>, VsImagePath, XpMax]
CharactersAchievement: [AchievementId, CharacterId, EarnedCount, Finish, LastSave, Start]
CharactersDirectiveTree: [CharacterId, CompletionTime, CurrentDirectiveTierId, CurrentLevel, DirectiveTreeId]
Objective: [ObjectiveGroupId, ObjectiveId, ObjectiveTypeId]
SkillSet: [Description, ImagePath, ImageSetId, Name, RequiredItemId, SkillPoints, SkillSetId]
EmpireScores: [Description, EndTime, Name, StartTime, TrackerDescription, TrackerName]
MarketingBundle: [CertPrice, Description, ImageId, MarketingBundleId, Name, ReleaseTime, StationCashPrice]
DirectiveTree: [Description, DirectiveTreeCategoryId, DirectiveTreeId, ImagePath, ImageSetId, Name]
CharactersStat: [CharacterId, LastSave, ProfileId, StatName, ValueDaily, ValueForever, ValueMonthly, ValueOneLifeMax, ValueWeekly]
Vehicle: [Cost, CostResourceId, Description, ImagePath, ImageSetId, Name, TypeId, TypeName, VehicleId]
EffectType: [Description, EffectTypeId]
DirectiveTier: [CompletionCount, DirectivePoints, DirectiveTierId, DirectiveTreeId, ImagePath, ImageSetId, Name, RewardSetId]
MapRegion: [FacilityId, FacilityName, FacilityType, FacilityTypeId, LocationX, LocationY, LocationZ, MapRegionId, RewardAmount, RewardCurrencyId, ZoneId]
Skill: [Description, GrantItemId, ImagePath, ImageSetId, Name, SkillId, SkillLineId, SkillLineIndex, SkillPoints]
SkillCategory: [Description, ImagePath, ImageSetId, Name, SkillCategoryId, SkillPoints, SkillSetId, SkillSetIndex]
SkillLine: [Description, ImagePath, ImageSetId, Name, SkillCategoryId, SkillCategoryIndex, SkillLineId, SkillPoints]
Achievement: [AchievementId, Description, ImagePath, ImageSetId, ItemId, Name, ObjectiveGroupId, Repeatable, RewardId]
Directive: [Description, DirectiveId, DirectiveTierId, DirectiveTreeId, ImagePath, ImageSetId, Name, ObjectiveSetId, QualifyRequirementId]
AbilityType: [AbilityTypeId, Description]
PlayerStateGroup2: [CanIronSight, CofGrowRate, CofMax, CofMin, CofRecoveryDelayMs, CofRecoveryDelayThreshold, CofRecoveryRate, CofShotsBeforePenalty, CofTurnPenalty, PlayerStateGroupId, PlayerStateId]
ZoneEffectType: [Description, ZoneEffectTypeId]
OutfitMemberExtended: [Alias, AliasLower, CharacterId, LeaderCharacterId, MemberCount, MemberRank, MemberRankOrdinal, MemberSince, Name, NameLower, OutfitId, TimeCreated]
Effect: [AbilityId, DurationSeconds, EffectId, EffectTypeId, IsDrain, ResistTypeId, TargetTypeId]
ZoneEffect: [AbilityId, ZoneEffectId, ZoneEffectTypeId]
Weapon: [EquipMs, FromIronSightsMs, HeatBleedOffRate, HeatCapacity, HeatOverheatPenaltyMs, MeleeDetectHeight, MeleeDetectWidth, MoveModifier, SprintRecoveryMs, ToIronSightsMs, TurnModifier, UnequipMs, WeaponGroupId, WeaponId]
Profile: [BackpedalSpeedModifier, Description, FactionId, ImagePath, ImageSetId, MovementSpeed, Name, ProfileId, ProfileTypeDescription, ProfileTypeId, SprintSpeedModifier, StrafeSpeedModifier]
Item: [ActivatableAbilityId, Description, FactionId, ImagePath, ImageSetId, IsDefaultAttachment, IsVehicleWeapon, ItemCategoryId, ItemId, ItemTypeId, MaxStackSize, Name, PassiveAbilityId, ReleaseTime, SkillSetId]
Projectile: [Acceleration, ArmDistance, DetonateDistance, DetonateOnContact, Drag, Gravity, Lifespan, LockonAcceleration, LockonLifespan, LockonLoseAngle, LockonSeekInFlight, ProjectileFlightTypeId, ProjectileId, Speed, SpeedMax, SticksToPlayers, Sticky, TetherDistance, TurnRate]
WeaponDatasheet: [Capacity, ClipSize, Damage, DamageMax, DamageMin, DirectDamage, FireCone, FireConeMax, FireConeMin, FireRateMs, FireRateMsMin, FireRateMxMax, IndirectDamage, ItemId, Range, ReloadMs, ReloadMsMax, ReloadMsMin, ShowClipSize, ShowFireModes, ShowRange]
CharactersStatByFaction: [CharacterId, LastSave, ProfileId, StatName, ValueDailyNc, ValueDailyTr, ValueDailyVs, ValueForeverNc, ValueForeverTr, ValueForeverVs, ValueMonthlyNc, ValueMonthlyTr, ValueMonthlyVs, ValueOneLifeMaxNc, ValueOneLifeMaxTr, ValueOneLifeMaxVs, ValueWeeklyNc, ValueWeeklyTr, ValueWeeklyVs]
Ability: [AbilityId, AbilityTypeId, DistanceMax, ExpireMsec, FirstUseDelayMsec, FlagToggle, NextUseDelayMsec, RadiusMax, ResourceCostPerMsec, ResourceFirstCost, ResourceTypeId, ReuseDelayMsec]
FireMode: [CofRecoil, Damage, DamageMax, DamageMaxRange, DamageMin, DamageMinRange, DamageRadius, DamageResistType, DamageTargetType, DamageType, DefaultZoom, Description, FireModeId, IndirectDamageMax, IndirectDamageMaxRange, IndirectDamageMin, IndirectDamageMinRange, IndirectDamageResistType, IndirectDamageTargetType, ItemId, MaxSpeed, MuzzleVelocity, PelletSpread, PelletsPerShot, PlayerStateGroupId, ProjectileDescription, ReloadChamberTimeMs, ReloadTimeMs, Speed, Type]
FireMode2: [AbilityId, AmmoSlot, ArmorPenetration, Automatic, CofOverride, CofPelletSpread, CofRange, CofRecoil, CofScalar, CofScalarMoving, DamageDirectEffectId, DamageHeadMultiplier, DamageIndirectEffectId, DamageLegsMultiplier, Description, FireAmmoPerShot, FireAutoFireMs, FireBurstCount, FireChargeUpMs, FireDelayMs, FireDetectRange, FireDurationMs, FireModeId, FireModeTypeId, FirePelletsPerShot, FireRefireMs, GriefImmune, HeatPerShot, HeatRecoveryDelayMs, HeatThreshold, IronSights, LaserGuided, LockonAcquireCloseMs, LockonAcquireFarMs, LockonAcquireMs, LockonAngle, LockonLoseMs, LockonMaintain, LockonRadius, LockonRange, LockonRangeClose, LockonRangeFar, LockonRequired, MaxDamage, MaxDamageInd, MaxDamageIndRadius, MaxDamageRange, MinDamage, MinDamageInd, MinDamageIndRadius, MinDamageRange, MoveModifier, PlayerStateGroupId, ProjectileSpeedOverride, RecoilAngleMax, RecoilAngleMin, RecoilFirstShotModifier, RecoilHorizontalMax, RecoilHorizontalMaxIncrease, RecoilHorizontalMin, RecoilHorizontalMinIncrease, RecoilHorizontalTolerance, RecoilIncrease, RecoilIncreaseCrouched, RecoilMagnitudeMax, RecoilMagnitudeMin, RecoilMaxTotalMagnitude, RecoilRecoveryAcceleration, RecoilRecoveryDelayMs, RecoilRecoveryRate, RecoilShotsAtMinMagnitude, ReloadAmmoFillMs, ReloadBlockAuto, ReloadChamberMs, ReloadContinuous, ReloadLoopEndMs, ReloadLoopStartMs, ReloadTimeMs, ShieldBypassPct, SprintFire, SwayAmplitudeX, SwayAmplitudeY, SwayCanSteady, SwayPeriodX, SwayPeriodY, TurnModifier, UseInWater, ZoomDefault]
